222222222222222
211111111111112
211111111111112
211111111111112
211111121111112
211111121111112
211111121111112
211111121131112
211111121111112
211111121111112
211111121111112
211111111111112
211111111111112
211111111111112
222222222222222